edubenchmark.com
                                                                           PETS/Animal
breed - My friend's dog breed is labradoodle
canines - dogs Canines tooth
coat - smooth/shaggy coat
companionable = компонейский
curl up next to - сввернуться калчиком рядом с
docile - послушный
domesticated - одомашненый
feathers - оперение
fur - шерстяной покров
hooves - копыта
puppy dog-eyes - щенячьи глазки
rodent - грызуны
stray -
to be put down -
to curb loneliness - сдерживать, усмирять
to tame - приученные, смиреный
amphibians - животные, которые живут на суще и в воде
battery farming - ферма с животными
captivity - breed in captivity
brink of extinction - на грани вымирания
teetering/poised/hovering on the brink - балансирующий/уравновешенный/ зависающий на грани
carnivores - meat-eating
conservation = сохранение природы
destruction of natural habitats
endangered - at the risk of extinction, находящийся под угрозой
fangs - клыки
roam/wander - бродить, склоняться.\ to walk slowly around or to a place, often without any particular sense of purpose or direction
aimlessly - бесцельно
guinea pig - a person used in medical or other experiments
herbivores - plants eater
mammals - animals/people who are milk fee
marsupials - pouch+animal = kangaroos, coala
pest - insect or animal, who damage a plants
poaching  - to illegally hunt birds, animals or fish on somebody else’s property or without permission
confines - limits or borders
cruelty/neglect - пренебрегать, упускать
logging - лесозаготовка